31
25
22 22 22 22 22 22 22 22 22 22 22 22 22 22 22 22 22 22 22 22 22 22 22 22 22 22 22 22 22 22 22
22 22 19 0 0 0 0 0 0 0 0 0 0 0 0 0 0 0 0 0 0 0 0 0 0 0 0 0 0 0 22
22 22 0 0 0 0 0 0 0 0 0 0 0 0 0 0 0 0 0 0 0 0 0 0 0 0 0 0 0 0 22
22 22 0 0 0 0 0 0 0 0 0 0 0 0 0 0 0 0 0 0 0 0 0 0 0 0 1 21 43 21 6
22 22 0 1 21 21 21 21 21 21 43 21 2 0 0 0 0 0 0 0 0 0 0 0 0 0 0 12 42 12 22
22 5 21 2 22 22 22 22 22 22 42 0 0 0 0 0 0 0 0 0 0 0 0 0 0 0 0 12 42 12 22
22 22 0 0 22 22 22 22 22 22 42 0 0 0 0 0 0 23 24 25 0 0 0 0 0 0 0 12 42 12 22
22 22 1 21 6 22 22 22 22 22 42 0 0 0 0 0 0 0 0 0 0 0 0 0 0 0 0 12 42 12 22
22 22 0 0 22 22 22 22 22 22 42 0 0 0 0 0 0 0 0 0 0 0 0 0 0 0 0 12 42 12 22
22 5 21 2 22 22 22 22 22 22 22 22 22 22 22 22 22 22 22 22 22 0 0 0 0 22 22 22 22 22 22
22 22 0 0 22 22 22 22 22 22 22 22 22 22 22 22 22 22 22 22 22 22 22 22 22 22 22 22 22 22 22
22 22 1 21 6 22 22 22 17 0 17 17 17 0 0 0 17 0 0 17 0 0 0 17 0 0 0 17 0 0 22
22 22 0 0 22 22 22 22 0 0 0 0 0 0 0 0 0 0 0 0 0 0 0 0 0 0 0 0 0 0 22
22 5 21 2 22 22 22 22 0 0 0 0 0 0 0 0 0 0 0 0 0 0 0 0 0 0 0 0 0 0 22
22 22 0 0 22 22 22 22 21 2 0 0 0 0 0 0 0 0 0 0 0 0 0 0 0 0 0 0 0 0 22
22 22 1 21 22 22 22 22 22 0 0 0 23 25 0 0 23 24 25 0 23 24 25 0 0 23 24 25 0 0 22
22 22 0 0 0 0 0 0 0 0 0 0 0 0 0 0 0 0 0 0 0 0 0 0 0 0 0 0 0 0 22
22 5 21 2 0 0 0 0 0 0 0 0 0 0 0 0 0 0 0 0 0 0 0 0 0 0 0 0 1 21 6
22 22 22 0 0 0 0 0 0 0 0 0 0 0 0 0 0 0 0 0 0 0 0 0 0 0 0 0 0 0 22
22 22 5 21 21 21 21 21 21 21 21 21 21 2 1 21 8 21 8 21 2 1 21 21 8 21 21 8 21 21 22
22 22 22 22 22 22 22 22 22 22 22 22 22 0 0 22 0 22 0 22 0 0 22 22 0 22 22 0 22 22 22
22 22 0 0 11 0 0 0 11 0 0 0 11 0 0 11 0 11 0 11 0 0 11 11 0 11 11 0 11 0 22
22 22 0 0 13 0 0 0 13 0 0 0 13 0 0 13 0 13 0 13 0 0 13 13 0 13 13 0 13 0 22
22 22 0 0 11 0 0 0 11 0 0 0 11 0 0 11 0 11 0 11 0 0 11 11 0 11 11 0 11 0 22
5 5 21 21 21 21 21 21 21 21 21 21 21 21 21 21 21 21 21 21 21 21 21 21 21 21 21 21 21 21 6