25
25
22 22 22 22 22 22 22 22 22 22 22 22 22 22 22 22 22 22 22 22 22 22 22 22 22 22
22 0 0 0 0 0 0 0 0 0 0 0 0 0 0 0 0 0 0 0 0 0 0 0 22 22
22 0 0 0 0 0 0 0 0 0 0 0 0 0 0 0 0 0 0 0 9 0 0 9 22 22
5 21 21 21 21 2 0 0 0 0 0 0 0 0 0 0 0 0 1 21 21 21 21 21 6 22
22 22 22 22 22 21 21 21 21 21 21 8 21 21 21 21 21 21 21 6 22 22 22 22 22 22
22 22 22 22 22 22 22 22 22 22 22 43 22 22 22 22 22 22 22 22 22 22 22 22 22 22
22 0 0 0 0 11 0 0 11 0 0 42 0 12 0 0 13 0 0 12 0 0 13 0 22 22
22 0 0 0 0 11 0 0 11 0 0 42 0 13 0 0 12 0 0 13 0 0 12 0 22 22
22 0 0 0 0 11 0 0 11 0 0 42 0 12 0 0 13 0 9 12 0 0 13 0 22 22
22 22 22 22 22 22 22 22 22 22 22 22 22 22 22 21 21 21 21 21 21 21 21 43 22 22
22 22 22 22 22 22 22 22 22 22 22 22 22 22 22 22 22 22 22 22 22 22 22 43 22 22
22 0 0 0 0 0 0 0 0 0 0 0 0 0 11 0 11 0 11 0 11 0 0 42 22 22
22 0 0 0 0 0 0 0 0 0 0 0 0 0 11 9 11 0 11 0 11 0 0 42 22 22
22 0 0 0 0 0 0 0 0 0 0 0 0 1 21 21 21 43 21 21 21 2 0 42 22 22
22 0 0 9 0 0 0 0 0 0 0 0 0 0 0 0 0 42 0 0 0 0 1 21 6 22
22 21 21 21 21 21 2 0 1 21 21 21 2 0 0 0 0 42 0 0 0 0 0 0 22 22
22 22 22 22 22 22 0 0 0 22 22 22 0 0 0 0 0 42 0 0 0 0 0 0 22 22
22 22 22 22 22 5 21 2 0 22 22 5 21 43 21 21 21 21 21 21 21 21 43 21 6 22
22 0 0 13 0 13 0 0 0 22 22 22 0 42 11 0 0 13 13 0 0 11 42 0 22 22
22 0 0 11 0 11 0 1 21 6 22 22 0 42 12 0 0 11 11 0 0 12 42 0 22 22
22 0 0 12 10 12 0 0 9 22 22 22 0 42 12 0 0 13 13 0 0 12 42 0 22 22
22 21 21 21 21 21 21 21 21 6 22 22 0 42 11 0 0 11 11 0 0 11 42 0 22 22
22 22 22 22 22 22 22 22 22 22 22 5 21 21 21 21 21 21 21 21 21 21 21 21 6 22
22 22 22 22 22 22 22 22 22 22 22 22 22 22 22 22 22 22 22 22 22 22 22 22 22 22
22 22 22 22 22 22 22 22 22 22 22 22 22 22 22 22 22 22 22 22 22 22 22 22 22 22
